Insultar con Propiedad
acerbo
acerado
acerote (remolón, huevón, acidioso)
achechado (hijo de papi, mimado, chiple, achichiguado, acidioso)
aciguatado (imbecil, pazguato, aguacatón (falto de entendimiento, tonto)), ajimbalado
Adán (hombre sucio, haraposo, desaliñado)
Adocenado (vulgar, mediocre)
Adoquín (persona inútil, muy torpe)
Aperreado (molesto)
Aporreador (persona que fatiga mucho a alguien)
apezgatado
Adocenado: vulgar o mediocre.
Adredista: que por costumbre actúa con una intención deliberada para su propio beneficio y sin importarle las otras personas. 


Chismoso: alcaucil, alparcero
Lelo, tonto, bobo: alelado, apangado
Cabrón, bribón: alfarnate
Ñango: alfeñique
Codo: pichicato
Gordo: amondogado


== De lo sexual o de la putería ==
anafrodita

Angojoso (alguien comúnmente angustiado, afligido)
Angurriento: persona que orina muy frecuentemente.
Callonca: prostituta. 
Capulina: mujer de mala vida. 
Casquivana: coqueta, fresca, frívola. 
Chirusa o chiruza: mujer de comportamiento vulgar o afectado. 
Concubina: Prostituta.
Congalero: prostituta.
Cucha: Prostituta, ramera, mujer de mala vida.
Cuclillo: Hombre al que le es infiel su mujer.
Entradora: Mujer facilona.
Entrona: Mujer accesible, coqueta y fácil de conquistar.

Viejo
antañón

== De la apariencia física BEGIN ==
Aparrada
Apersonado (de mala presencia)
Ascoroso: asqueroso.
Bichicome: persona indigente, que vive de desperdicios. 
Birriosa: de mala calidad o aspecto. 
Bisunto: sucio, sobado, grasiento. 
Bodrio: dicho de una persona físicamente desagradable, descuidada, desarreglada o de mal gusto. 
Cachiporra: farsante, vanidoso.
Caima: dicho de una persona o cosa sin gracia.
Callo: mujer muy fea. 
Carantoña: mujer vieja y fea que se aplica aceites y se compone el rostro para disimular su fealdad. 
Cascado: persona que está muy jodida o traqueteada.
Catzagua: mugriento, chamagoso, sucio.  
Cermeño: hombre tosco, sucio, necio.
Choclón: desaliñado, mal vestido. 
Chungo: de mal aspecto, en mal estado o de mala calidad. 
Cuija: Mujer flaca y fea.
Desandrajado: Andrajoso, desastrado.
Desapuesto: Desarreglado, de mala disposición y presencia.
Desaseado: Falto de aseo.
Descachalandrado: Desaliñado, andrajoso.
Descarrachado: persona descuidada o desaliñada.
Desemejado: Terrible, desfigurado, muy feo.
Desguañado: Desarreglado.
Disforme: Feo, horroroso, monstruoso.
Esperpento: Persona o cosa vieja, desaliñada o de mal aspecto.
== De la apariencia física END ==


== Del carácter  (terquedad, temor, ... ) ==
Apocoyado: persona temerosa, pusilánime, abatida.
Argel: persona que no tiene gracia ni inspira simpatía.
arisco: áspero, de carácter intratable.
Arrabalero: persona descarada y de carácter grosero.
arrotado: persona maleducada
andrajo: persona muy despreciable. 
Blofero: persona habladora o que presume o alardea de lo que no es o no tiene. 
Bofe: ser muy pesado o inoportuno. 
Bolero: mentiroso. 
Boletero: que tiene la costumbre de mentir. 
Bombeta: orgulloso, creído, presumido. 
Cabarrón: persona pesada y molesta.
cacaseno: hombre despreciable, necio. 
Cachafaz: descarado, sinverguenza.
Cachancán: persona aduladora, servil. 
Cachetero: persona que se aprovecha de los demás. 
Caco: hombre muy tímido, cobarde. 
Caguillas: tacaño, avaro, miserable.
Carantamaula: persona malencarada. 
Cardo: persona brusca o insociable. 
Caustico: mordaz, agresivo.
Caviloso: chismoso, averiguador, suspicaz. 
Cernícalo: se aplica a una persona despreciable por grosera, insociable, poco amable, falta de sensibilidad e incapaz de dar afecto. 
Cervigudo: porfiado, terco, testarudo.
Chirle: insípido, de poco interés, sin gracia. 
Chirrichote: necio, presumido.  
Chotis: dicho de una persona muy tacaña. 
Contumaz: Obstinado o rebelde.
Contumelioso: afrentoso, injurioso, ofensivo.
Derramaplaceres: Aguafiestas.
Derramasolaces: Persona que turba cualquier diversión o regocijo.
Desaborido: Persona sosa, sin carácter.
Desdonado: Que carece de gracia o de tino en hacer o decir algo.
Embolador: Limpiabotas, adulador, lamehuevos.
Embustidor: Mentiroso.
Enconado: Persona terca y obstinada en 
Enodrino: Apocado o tímido.

== Del chisme ==
Chafardero: chismoso, Cotilla.
Conventillero: chismoso, metiche, entrometido.
Cuchareta: Persona entrometida.
Cuzo: Persona indiscreta y fisgona.

== Del olor ==
Apuscaguado (mohoso, maloliente )

== Del ser un culero o grosero o charlatán BEGIN ==
Arlote: holgazán, bribón
Arrogador: 
Anonador: persona que humilla, abate. 
Aperado: persona bien dotada para urdir intrigas y sacar provecho de ellas. 
Astroso: vil o despreciable.
Bacín: persona despreciable por sus acciones. 
Bandarra: sinvergüenza. 
Barrabás: persona mala, traviesa, desobediente. 
Barzón: persona vaga que no le gusta trabajar. 
Cachancán: persona aduladora, servil. 
Cachetero: persona que se aprovecha de los demás.
Cachivache: hombre ridiculo, embustero e inútil.
Cacique: despota, tirano, arbitrario, mandón.
Camandulero: hipócrita, disimulado, abusivo, vividor.
Camastrón: persona hipócrita. 
Carajete: persona muy despreciable. 
Cerril: grosero, tosco, rústico. 
Chabacano: tiene modales rudos o groseros, porque es maleducada o ignorante. 
Chacharero: charlatán. 
Chanflón: persona despreciable. 
Chilero: persona mentirosa. 
Chilmolero: latoso, fastidioso. 
Chiquibaile: ladrón. 
Chiviento: mentiroso. 
Chulo: bravucón, insolente, rufián. 
Descalabrado: Imprudente, arrojado.
Descastado: Ingrato.
Descerrejado: De perversa vida y mala naturaleza.
Cariraído: sinvergûenza. 
Carroña: persona ruin, despreciable. 
Cascarria: persona o cosa despreciable. 
Deshonrible: Sinvergûenza y despreciable.
Despachurrado: Persona ridícula y despreciable.
Deyecto: Persona vil, despreciable.
Drope: Dicho de un hombre despreciable.
Echacantos: Persona despreciable e insificante.
Echacuervos: Hombre embustero y despreciable.
Enconoso: Persona de mala voluntad con los demás.
Escomendrijo: Criatura ruin y desmedrada.
Espácico: Desgraciado o de ma agûero.
Espernible: Persona despreciable.
Espurio: persona que no es auténtica. Bastardo, falso o engañoso.
== Del ser un culero o grosero o charlatán END ==


De la vejez:
Antañón: muy viejo. 
Carcamán: viejo pesado, torpe en el andar. 
Carraspiento: dicho de un anciano despreciable.

== De la pendejez (y tosquedad, grosería) ==
adundado: tonto, falto de entendimiento.
Aguacató: "" (lo anterior)
agalambado: simple, tonto, bobo, baboso.
Ajimbalado: tonto, atarantado. 
Alfeñique: perdona de comprensión y aspectos débiles. 
Andorrero: Persona que anda de una parte a otra fingiendo hacer algo útil. 
Apangado: individuo tonto, con falta de entendimiento, con falta de entendimiento o razón.
Apezgatado: sinónimo de torpe, pendejo. 
Asomagado: tarugo, baboso, simple o cosa por el estilo ("ya quedaste asomagado de tanto Nintendo)
Atarailado: falto de razón o entendimiento. 
Atochado: atontado.
Babaco: tonto, simple. 
Babanca: persona boba.
Babasfrias: papanatas, baboso. 
Babieca: persona floja y boba.
Babilón: torpe, bobo. 
Bagaje: persona simple, inútil o torpe. 
Bambarria: persona boba o Tonta.
Banana: persona Tonta, boba.
Barjoleta: tonto, necio, mentecato.
Bato: hombre tonto y rústico, de pocos alcances. 
bembo: bobo, baboso, falto de entendimiento o razón. 
Beocio: ignorante, estúpido, tonto.
Berenga: 
Berzas: persona ignorante o necia. 
Bestiún: persona ruda e ignorante. 
Bobalías: persona muy boba. 
Bocatero: fanfarrón, hablador.
Bodoque: torpe, zafio, patan, necio. 
Boje: simple, bobo. 
Bolo: hombre ignorante, inepto o de escasa habilidad. 
Bonete: persona Tonta e idiota. 
Botarate: persona alborotada y de poco juicio que habla y obra sin pensar. 
Boto: torpe.
Bozal: simple. Necio. O idiota. 
Bucéfalo: dicho de un hombre rudo, estupido e incapaz, torpe e ignorante. 
Burdo: basto, grosero, tosco. 
Calabacín: persona inepta, poco inteligente. 
Calabaza: persona torpe. 
Calambuco: persona simple o de presencia de tonto. 
Camote: persona Tonta, necia, simple. 
Camueso: hombre necio e ignorante, que busca hacer su voluntad. 
Cancano: persona Tonta o Simple. 
Cantimpla: tonto, falto de entendimiento o razón. 
Cascabelero: dicho de una persona de poco seso, particularmente alegre y desenfadada. 
Cascaciruelas: persona inútil y despreciable. 
Cateto: hombre ignorante y tosco por ser campesino, o de manera que hace que lo parezca; paleto.
Cayuco: persona torpe. 
Cazo: persona Tonta. 
Cebollino: persona torpe e ignorante. 
Cendolilla: muchacha inquieta y de poco juicio. 
Cenutrio: hombre lerdo, Zoquete, estupido. 
Ceporro: persona torpe, cerrada e ignorante.
Cerrero: persona inculta, huraña. 
Chafandín: persona vanidosa y de poco seso. 
Chagra: inculto. 
Chalado: alelado, falto de seso o juicio.
Chambón: poco hábil, torpe. 
Chancleta: persona inepta, persona de modales groseros, de comportamiento vulgar. 
Charrulo: persona inútil o inepta para hacer algo. 
Chato: intelectualmente pobre.
Chayota: persona Tonta, Lerda, falta de iniciativa.
Chontal: persona rústica e inculta. 
Chorompa: persona que actúa de manera Tonta.
Chorra: hombre tonto, estúpido. 
Chuña: persona que no tiene valía, dinero ni educación. 
Chuto: persona tosca, inculta. 
Cipote: hombre torpe, zonzo, bobo. 
Cochero: persona de lenguaje grosero y obseno.
Cojudo: tonto, bobo.
Congo: persona que es utilizada por otros para que haga trabajos que nadie quiere hacer.
Demorón: Lento, pausado, tardío.
Desmanotado: Inútil, torpe.
Desorejado: Tonto, irresponsable y desobediente.
Dundo: Dicho de alguien tonto, de poco entendimiento. 

Interesantes:
Angurrientos: persona que orina frecuentemente.
Baldonada: prostituta.



== De lo codo ==
Pichicato.
Cerracatín: tacaño, miserable. 
Tacaño, miserable.
Durañón: Persona tacaña, miserable.

picadill
PIN de Airbnb. Nunca compartas tu codigo con nadie; los em...


== De la flojez o quizás la inutilidad ==
Apozolado: floja
Arlote: holgazán, bribón. 
Bigardo: vago, holgazán.
Cachivache: hombre ridiculo, embustero e inútil.  
Calmoso: persona lenta, perezosa.
Cansón: aburrido, inestable inconstante. 
Capigorrón: ocioso y vagabundo. 
Changallo: perezoso.
Chota: flojo, pusilánime. 
Cirigallo: persona qué pasa el tiempo yendo y viniendo, sin hacer nada de provecho. 
Cojonudo: Persona perezosa en extremo o floja.
Cucañero: Que tiene maña para lograr las cosas con poco trabajo o a costa de los demás.
Enatío: Ocioso y superfluo.

== Del olor ==
Apuscaguado: que huele mal.
C2833100

== De la locura ==
Ateperetado: medio loco. 

8007135555

De la debilidad (pusilanimidad, servil)

Belitre: Débil, enclenque. ￼ 2. Pícaro, ruin y de viles costumbres.
Calzonazos: hombre débil que se deja dominar, especialmente por una mujer. 
Cansón: aburrido, inestable, inconstante. 
Chupamedia: persona aduladora, servil. 

 
== Del ser un cobarde o pussy ==
Calcillas: hombre tímido o cobarde. 
Cañuto: soplón.
Cuculmeque: persona miedosa, cobarderde.
Culicunco: Cobarde, temeroso.

De la briaguez
Bútago: ebrio, borracho, bebedor. 

== De la putería ==
Cachirila: ramera. 
Coja: prostituta.

== De la debilidad / cobardía ==
Cajeta: cobarde, pendejón, bizcocho. 

== De la ridiculez ==
Calandraco: persona ridicula.

== Del ser castroso BEGIN ==
Calilla: persona molesta y pesada. 
Caparra: persona atosigante e impertinente en una conversación o advertencias. 
Cargante: que carga, molesta, o cansa por su insistencia. 
Caridelantero: descarado, entrometido. 
Cataplasma: persona densa, pesada, simple y fastuosos.
Chanca: persona achacosa. 
Chavón: persona que molesta mucho. 
Chinchorrero: impertinente. 
Chinchoso: persona molesta y pesada. 
Chirimía: persona que habla mucho y con voz desagradable y aguda. 
Chivón: persona fastidiosa y cargante. 
Colagogo: Persona que resulta molesta, fastidiosa.
Conduerma: Persona o asunto que produce más molestas que provecho.
Coñazo: Persona latosa o insoportable.
Coñete: codo, tacaño, insoportable.
Endino: Persona traviesa que da lata.
Escorchador: Persona fastidiosa, enfadosa.
Esantagustos: Persona de mal carácter que turba la alegría de los demás.
== Del ser castroso END ==



== De la pretensión BEGIN ==
Camelista: persona que practica el camelo -- cosa o noticia que se hace pasar por buena -- y especialmente cosa en la que aparenta conocimientos, virtudes, o cualidades que no posee. 
== De la pretensión END ==

== Del humor ==
Cariscedo: áspero, desagradable, enojado. 
Casauite: persona de mal carácter.

== Del poco valor / no valer verga  / adulador / pocos huevos ==
Chupatintas: oficinista de poca categoría. 
Cobista: adulador. 
Conato: persona con poca determinación.
Don petate: Ser un mequetrefe, un pobre diablo.
Embeleco: Persona o cosa fútil, molesta o enfadosa.


== De la hueva ==
Castaña: persona o cosa aburrida o fastidiosa. 

== De los nervios, preocupación ==
Cominero: Dicho de alguien que se preocupa por minucias o nimiedades.

== Del ser un ladrón == 
Deprendador: ladrón.
Engatado: ladrón.

== De la locura ==
Desentido: Loco, necio.

== De la fanfarronería ==
Echón: Fanfarrón, petulante o jactancioso.
Elato: Soberbio, altivo o presuntuoso.

== De la pobreza ==
Egeno: Pobre, escaso o miserable.

== Del que engaña ==

Embaidor: Embaucador, engañador.
Embelecador: Que engaña con trucos y falsas apariencias.

== De la mamonería ==
Encastillado: Altivo y soberbio.
Encopetado: Presumido.
Engallado: Engreído, altanero o soberbio.
Engolado: dicho de una persona vanidosa, engreída, altanera.
Engrupido: Soberbio por vanidoso

== Afeminado ==
Encolado: Hombre presumido y afeminado.

== De la mentira ==
Engañabobos: Persona que pretende embaucar o deslumbrar.
Engañamundo: Engañador.
Engañapichanga: Charlatán o engañabobos.

== De las modas ==
